1 1 1 1 1 1 1 1 1 1 1 1 1 1 1 1 1 1 1 1
1 7 6 7 6 6 6 7 6 7 7 7 7 7 7 7 7 7 7 1
1 7 7 7 6 7 6 7 7 7 7 7 7 7 7 7 7 7 7 1
1 7 7 7 7 7 7 7 7 7 7 7 7 7 7 7 7 7 7 1
1 7 1 7 7 7 7 7 1 7 7 7 7 7 7 7 7 7 7 1
1 7 7 7 7 7 7 7 7 7 7 7 7 7 7 7 7 7 7 1
1 7 7 7 7 7 7 7 7 7 7 7 7 1 7 7 1 7 7 1
1 7 1 7 7 7 7 7 1 7 7 7 7 7 7 7 7 7 7 1
1 7 7 7 7 7 7 7 7 7 1 1 1 1 7 7 1 1 1 1
1 7 7 7 7 7 7 7 7 7 1 0 4 4 0 0 0 0 0 0
1 7 1 7 7 7 7 7 1 7 1 0 0 0 0 0 0 0 0 0
1 7 7 7 7 7 7 7 7 7 1 4 0 0 0 0 4 4 0 0
1 7 7 7 7 7 7 7 7 7 1 4 4 0 4 0 0 0 0 4
1 7 1 7 7 7 7 7 1 7 1 2 4 0 0 0 0 0 4 4
1 7 7 7 7 7 7 7 7 7 1 2 2 4 4 4 4 4 4 2
1 1 1 1 1 1 1 1 1 1 1 2 2 2 2 2 4 4 2 2